#.......................#
####....................#
#...................=...#
#....=G$G=......Z.......#
#.-.....@............-.-#
#..............B........#
#########################