#.......................#
####....................#
#...................=...#
#....=G$G=......=.......#
#.-.....@............-.-#
#.......................#
#########################