#.........
####......
#.........
#....$?$?$
#.........
#@........
##########