#.........
####......
#.........
#....$$$$$
#.........
#@........
##########