#.........
####......
#.........
#....=?$?=
#.........
#..@......
##########