#.........
####......
#.........
#....=G$G=
#.......@.
#.........
##########