.......................................
.......................................
.......................................
.......................................
.....................?.................
.......................................
.......................................
.......................................
...............?...=G=?=...............
.......................................
............................\/.........
..@.........................[].........
#######################################
#######################################