.......................................
.......................................
.......................................
.......................................
.....................?.................
.......................................
.......................................
.......................................
...............?...=?=?=...............
.......................................
..@....................................
...........................&...........
#######################################
#######################################