.......................................
.......................................
.......................................
.......................................
.....................?.................
.......................................
.......................................
.......................................
...............?.../?/?/...............
.......................................
..7....................................
...........................&...........
#######################################
#######################################